######
#*##S#
#----#
#--#-#
#----#
######