######
#*-#S#
#-#--#
##---#
#----#
######