######
#-##*#
#-#--#
#----#
#-PS-#
######